11111
10P01
10001
1E0C1
1C001
11111