11111111111111111111111111111111111
10E000P00000000000100000000C0000001
11111100000000000010011111110000001
10000100000011100000000000000000C01
10C0010000010C001110000C00000111111
100C0000000100000C10000000C00000C01
11111111111111111111111111111111111
