1111111111111111111111111111111111
1E000000N000000C00000C000000000101
1010010100100000101001000000010101
1010010010101010001001000000010101
1P000N000C00C0000000000N00000000C1
1111111111111111111111111111111111